NO ./textures/vangogh.png
SO ./textures/flowers.png
WE ./textures/sunflowers.png
EA ./textures/road.png

F 51,102,0
C 0,0,102

1111111111111111111111111
10000000000000000000001
1000001000101010010110011
1000000000111100000100111
10000011001  100000000001
10000011001111000000000011111111
1111000000000000000010001
1111111111110111111111111
11000000110101011100000010001
10000000000000001100000010001
10000000000000001101010000001
110000N111010101110101011000111
11110111 1110101 101110000001
11111111 1111111 111111111111